0 10 5 2 2 2 2 2 2 2 2 2 2 2 6 9
10 5 0 0 0 0 0 0 0 0 0 0 0 0 0 6
5 0 0 0 0 0 0 0 0 0 0 0 0 0 0 3
4 0 0 0 0 0 0 0 0 0 0 0 0 0 0 3
4 0 0 0 0 0 0 0 0 0 0 0 0 0 0 3
4 0 0 0 0 0 0 0 0 0 0 0 0 0 0 3
4 0 0 0 0 0 0 0 0 0 0 0 0 0 0 3
4 0 0 0 0 0 0 0 0 0 0 0 0 0 0 3
4 0 0 0 0 0 0 0 0 0 0 0 0 0 0 3
4 0 0 0 0 0 0 0 0 0 0 0 0 0 0 3
8 0 0 0 0 0 0 0 0 0 0 0 0 0 0 7
12 8 1 1 1 1 1 1 1 1 1 1 1 1 7 11
