0 0 0 0 0 0 0 0 0 0 0 0 0 0 0 0 0 0 0 0 0 0 0 0 0
0 0 0 0 0 0 0 0 0 0 0 0 0 0 0 0 0 0 0 0 0 0 0 0 0
0 0 0 0 10 5 2 2 2 2 2 2 2 2 2 2 2 6 9 0 0 0 0 0 0
0 0 0 10 5 0 0 0 29 23 25 25 15 20 0 0 0 0 6 0 0 0 0 0 0
0 0 0 5 0 0 28 21 21 18 24 24 18 18 21 33 0 0 3 0 0 0 0 0 0
0 0 0 4 0 0 30 13 32 13 32 13 32 13 32 14 0 0 3 0 0 0 0 0 0
0 0 0 4 0 0 22 32 13 32 13 32 13 32 13 31 0 0 3 0 0 0 0 0 0
0 0 0 4 0 0 22 13 32 13 32 13 32 13 32 31 0 0 3 0 0 0 0 0 0
0 0 0 4 0 0 27 32 13 32 13 32 13 32 13 31 0 0 3 0 0 0 0 0 0
0 0 0 4 0 0 30 13 32 13 32 13 32 13 32 31 0 0 3 0 0 0 0 0 0
0 0 0 4 0 0 34 21 21 21 21 21 21 21 0 26 0 0 3 0 0 0 0 0 0
0 0 0 4 0 0 0 0 0 0 0 0 0 0 0 0 0 0 3 0 0 0 0 0 0
0 0 0 8 0 0 0 0 0 0 0 0 0 0 0 0 0 0 7 0 0 0 0 0 0
0 0 0 12 8 1 1 1 1 1 1 1 1 1 1 1 1 7 11 0 0 0 0 0 0
0 0 0 0 0 0 0 0 0 0 0 0 0 0 0 0 0 0 0 0 0 0 0 0 0
0 0 0 0 0 0 0 0 0 0 0 0 0 0 0 0 0 0 0 0 0 0 0 0 0
0 0 0 0 0 0 0 0 0 0 0 0 0 0 0 0 0 0 0 0 0 0 0 0 0
0 0 0 0 0 0 0 0 0 0 0 0 0 0 0 0 0 0 0 0 0 0 0 0 0
21 0 0 0 0 0 0 0 0 0 0 0 0 0 0 0 0 0 0 0 0 0 0 0 0 0
